⋅⋅⋅⋅⋅⋅⋅⋅⋅⋅⋅⋅⋅
⋅⋅⋅⋅⋅⋅⋅⋅⋅⋅⋅⋅⋅
⋅⋅⋅⋅●⋅⋅●⋅●⋅⋅⋅
⋅⋅●●⋅●⋅●●●⋅⋅⋅
⋅⋅⋅●⋅⋅⋅⋅⋅⋅●⋅⋅
⋅⋅●●⋅⋅⋅⋅⋅●⋅⋅⋅
⋅⋅⋅⋅⋅⋅⋅⋅⋅⋅⋅⋅⋅
⋅⋅⋅●⋅⋅⋅⋅⋅●●⋅⋅
⋅⋅●⋅⋅⋅⋅⋅⋅●⋅⋅⋅
⋅⋅⋅●●●⋅●⋅●●⋅⋅
⋅⋅⋅●⋅●⋅⋅●⋅⋅⋅⋅
⋅⋅⋅⋅⋅⋅⋅⋅⋅⋅⋅⋅⋅
⋅⋅⋅⋅⋅⋅⋅⋅⋅⋅⋅⋅⋅
