⋅⋅⋅⋅⋅⋅⋅⋅⋅⋅⋅⋅⋅⋅⋅⋅⋅⋅⋅⋅⋅⋅
⋅●●⋅⋅⋅⋅⋅⋅⋅⋅⋅⋅⋅⋅⋅⋅⋅⋅●●⋅
⋅⋅●⋅⋅⋅⋅⋅⋅⋅⋅⋅⋅⋅⋅⋅⋅⋅⋅●⋅⋅
⋅⋅●⋅●⋅⋅⋅⋅⋅⋅⋅⋅⋅⋅⋅⋅●⋅●⋅⋅
⋅⋅⋅●●⋅⋅⋅⋅⋅⋅⋅⋅⋅⋅⋅⋅●●⋅⋅⋅
⋅⋅⋅⋅⋅⋅⋅⋅●⋅⋅⋅⋅●⋅⋅⋅⋅⋅⋅⋅⋅
⋅⋅⋅⋅⋅⋅●●⋅●●●●⋅●●⋅⋅⋅⋅⋅⋅
⋅⋅⋅⋅⋅⋅⋅⋅●⋅⋅⋅⋅●⋅⋅⋅⋅⋅⋅⋅⋅
⋅⋅⋅●●⋅⋅⋅⋅⋅⋅⋅⋅⋅⋅⋅⋅●●⋅⋅⋅
⋅⋅●⋅●⋅⋅⋅⋅⋅⋅⋅⋅⋅⋅⋅⋅●⋅●⋅⋅
⋅⋅●⋅⋅⋅⋅⋅⋅⋅⋅⋅⋅⋅⋅⋅⋅⋅⋅●⋅⋅
⋅●●⋅⋅⋅⋅⋅⋅⋅⋅⋅⋅⋅⋅⋅⋅⋅⋅●●⋅
⋅⋅⋅⋅⋅⋅⋅⋅⋅⋅⋅⋅⋅⋅⋅⋅⋅⋅⋅⋅⋅⋅
